0000000000000000
0000000000000000
0000000000022220
1111100000020020
0000100011110020
0000100010020020
0000100010022220
0000111110000000
0000000000000000
0000000000000000
0000000000000000
0000000000000000